####################
#..................#                  
#..................#
#.....##...........#
#..................#
#..................#
#..................#
#...........##.....#
#...........##.....#
#..................#
#..................#
#..................#
#...#..............#
#...#......###.....#
#...#........##....#
#.............#....#
#..................#
#..................#
#..................#
####################